Tutorial
5 11
+++++......
+   +++++++
+ W   #  *+
+   +++++++
+++++......