First Steps
10 12
..+++++.....
..+   +.....
..+# #+.....
+++   ++....
+  #W  +....
+ + ++ +++++
+ + ++ +  *+
+         *+
++++++++  *+
.......+++++