Workshop Panic
9 8
..+++++.
+++   +.
+*W#  +.
+++ #*++
+*++   +
+ + *  +
+# # #*+
+   +  +
++++++++