Error Two Players
5 11
+++++......
+   +++++++
+ PW* ##  +
+   +++++++
+++++......