Sliding Boxes
12 11
++++++++...
+  +   +...
+W  #  +...
+ #++ +++++
++ +* ++  +
.+ +*   # +
.+ +* ++  +
.+ +*+++ ++
.+        +
.++ #     +
..++++++  +
.......++++