Error A Character Not Handeled
5 11
+++++......
+ F +++++++
+ WW* #   +
+   +++++++
+++++......