Error No Player
5 11
+++++......
+   +++++++
+   * #   +
+   +++++++
+++++......