Error More Boxes
5 11
+++++......
+   +++++++
+ W ##O  *+
+   +++++++
+++++......