Dead Road
11 9
+++++++++
++    **+
++  +++ +
+++   + +
+++ # + +
+++#W#  +
+*  ##  +
++     ++
+  +++ ++
+   *+*++
+++++++++