Error No Boxes No Points
5 11
+++++......
+   +++++++
+ W       +
+   +++++++
+++++......